...###
..##.#.####
.##..###..#
##.....1..#
#...@..#..#
###..###..#
..#..#....#
.##.##.#.##
.#..1...##
.#.....##
.#######