############.
#@#....#...#.
#...#.#..#.##
#.##....#..#.
#########.##.
##......#..##
##.#..###..#.
#..#.......##
#.##########.
#.#......##..
#.####..##...
#......##....
########.....