///////////////////////////////////////////////////
/....1.@........#........3.....#...###!0..#3##0#%./
/...#....####2....#....#.....#....#....#.#..1.#.../
/.###...#....##..13.....#2#....#...3..##....####../
/h#....#..##..2....#0......#...#.#1..#...##2....../
/#...1..#..##..#..#1.....#..#...#......##.....2.../
/####..##..#..1#%.#..1......#....%....#..1......../
/..#...#......####2###...####........#....%....#../
/...#......#2.........#..#.....2#######.........../
/.#..3........%#######....2.....#........#......../
/..%..#########......%.....#####......#.......#.../
/......#..1.....3..............#.........3......../
/.#...##...1.......#.......2...........#.....%...c/
///////////////////////////////////////////////////